##########################
#........................#
#.>......................#
#........................#
#..............<.........#
#........................#
#........................#
#........................#
#.........x..............#
######..............######
#........................#
#........................#
#..............<.........#
#........................#
#........................#
#........................#
#........................#
#.>......................#
#........................#
#........................#
##########################
