####################
#..................#
#..>...............#
#..................#
#........#####.....#
#............#.....#
#...........x#.....#
########.....#.....#
#............#.....#
#........#####.....#
#..................#
#..................#
#..>...............#
#..................#
####################
